12:12
59 00 00 00 00 00 00 00 00 00 00 00 
17 17 17 00 17 00 17 17 17 17 00 00 
00 00 00 00 17 32 17 00 00 17 00 00 
32 85 00 00 17 32 17 00 00 17 00 00 
00 00 00 00 17 32 17 00 85 17 00 00 
00 00 00 00 17 17 17 00 00 17 00 00 
00 00 00 00 00 00 00 00 00 17 00 17 
00 18 18 18 00 00 00 37 00 17 00 00 
00 18 17 18 00 00 00 00 00 17 00 00 
00 18 96 18 85 00 00 00 00 17 00 00 
32 17 17 00 17 64 17 17 17 17 38 00 
00 00 62 00 00 00 00 00 00 00 00 128 

